3,0,0,0,0,0,0,0,0,0,0,0,0,0,0,0
3,0,20,0,3,3,3,3,3,3,3,0,0,0,0,15
3,0,0,0,0,0,0,0,0,0,0,0,0,0,0,15
3,0,0,0,0,0,0,0,0,0,0,0,0,0,0,15
3,0,0,0,0,12,12,12,12,12,0,0,0,0,0,15
3,0,0,0,0,0,0,0,0,0,0,0,0,0,0,15
3,0,0,0,12,12,12,12,12,12,12,0,0,0,0,15
3,0,0,0,0,0,0,0,0,0,0,0,0,0,0,15
3,0,0,0,12,12,12,12,12,12,12,0,0,0,0,15
3,0,0,0,3,3,3,3,3,3,3,0,0,0,0,15
3,0,0,0,3,3,3,3,3,3,3,0,0,17,0,16
3,0,0,0,3,3,3,3,3,3,3,0,0,0,0,0
1,1,1,1,1,1,1,1,1,1,1,1,1,1,1,1
1,1,1,1,1,1,1,1,1,1,1,1,1,1,1,1
